  1 2 3 4 5 6 7 8
1 * * * * * * _ _
2 * * * * * * _ _
3 * * * _ _ _ _ _
4 * * * _ _ _ _ _


  1 2 3
1 * * *
2 * * *
3 * * *